Your-Id,Debited,Credited,Balance-History,Transaction-Time
&Ab3b@IQ5p,-----,$11.0,$138552.0,2021-09-23 23:50:36.077633
&Ab3b@IQ5p,$1.0,-----,$138541.0,2021-09-23 23:50:21.458063
&Ab3b@IQ5p,$59000.0,-----,$138542.0,2021-09-23 23:42:44.495300
&Ab3b@IQ5p,-----,$100998.0,$197542.0,2021-09-23 23:42:29.485111
&Ab3b@IQ5p,$3456.0,-----,$96544.0,2021-09-23 23:31:17.805710
&Ab3b@IQ5p,-----,$100000.0,$100000.0,2021-09-23 23:31:06.457596
